
NO          textures/cat/cat.xpm
SO                                 textures/cat_angry/cat_angry.xpm
EA                textures/cat_omg/cat_omg.xpm
WE     textures/cat_happy/cat_happy.xpm
DOOR textures/cat_mouth_open.xpm

F 235,144,245
C 164,226,252

11111111
100D0001
100D0001
10ND0001
11111111
