

EA  textures/cat_very_angry/cat_very_angry0.xpm



WE  textures/cat_blush/cat_blush0.xpm




SO  textures/cat_cute/cat_cute0.xpm



NO  textures/cat_dance/cat_dance0.xpm


F  100, 50, 0

C 50,100,0


11111
10S01
11111
