
NO          textures/cat/cat.xpm
SO                                 textures/cat_angry/cat_angry.xpm
EA                textures/cat_omg/cat_omg.xpm
WE     textures/cat_happy/cat_happy.xpm

F 255,100,0
C 225,30,0

11111111
10100001
10000001
10N10001
11111111
