       1       1
       1       1
       1       1
       1       1
11111111111111111111111
       100000001
       100000001
       1000N0001
       100000001
11111111111111111111111
       1       1
       1       1
       1       1
       1       1