     1111111111111
    110000000000011
   11000000000000011
  1100000000000000011
  1000000000000000001
  1000000000000000001
  1000000000000000001
  1000000000000000001
  100000000N000000001
  1000000000000000001
  1000000000000000001
  1000000000000000001
  1000000000000000001
  1100000000000000011
   11000000000000011
    110000000000011
     1111111111111