1                 1
 1               1
  1             1
   1           1
    1         1
     1       1
      1     1
       1   1
        111
        101
        111
       1   1
      1     1
     1       1
    1         1
   1           1
  1             1
 1               1
1                 1
