NO          textures/cat/cat.xpm
SO                                 textures/cat_angry/cat_angry0.xpm
EA                textures/cat_omg/cat_omg.xpm
WE     textures/cat_happy/cat_happy.xpm

F 255,100,0
C 225,30,0

DOOR  textures/cat_very_angry/cat_very_angry.xpm

        1111111111111111111111111
        1000000000110000000000001
        1011000001110000000000001
        1001000000000000000000001
111111111011000001D10000000000001
1000000000D1000001D10111111111111
1111011111D111011100000010001
1111011111D111011101010010001
11000000110101011100000010001
1000000000000000DD000000D0001
10000000000000001101010010001
11000001110101011111011110N0111
11110111 1110101 101111010001
11111111 1111111 111111111111
